1111111111111
11010000001C1
1000011111011
1E0011P0C0001
1111111111111