111111111111111
10010000000C001
100001111100001
1P0010E00C00001
111111111111111