11111111111
1C00C00CC01
101010C1001
1P00C0C00E1
11111111111
