1111111111
101P000001
1010101001
1011C101E1
1111111111
